12 13
------_------
-----___-----
----_____----
--______++---
--______+$$--
--______+$$--
--______+$$--
--______+++--
--_______+---
--_______----
--______-----
--_____------
