9 10
----------
-________-
-____|___-
-________-
-_______--
-___P___--
-_______--
-_______--
----------