14 26
---$$$$$$$$$$$$$$$$$$$----
--------________----------
--------__M___|_----------
--------________----------
--------________----------
--------______+++---------
--------_____++B+---------
--------______+++---------
--------________----------
--------________----------
--------___P____----------
--------________----------
--------______V_----------
---$$$$$$$$$$$$$$$$$$$----
