14 26
--------------------------
-_________|______--___V__-
-_______________B--______-
-________________________-
-________M___++++++++____-
-__>>>_______++++++++++__-
-_>>$$$$$$$$$$$$$$$$$$++_-
-__>$$$$$$$$$$$$$$$$$$+B+-
-___$$$$$$$$$$$$$$$$$$+++-
-___$$$$$$$$$$$$$$$$$$+++-
-____________________+++_-
-_____P>>>>___________V__-
-________________________-
--------------------------
