9 12
------------
-________B_-
-_M__|__$$_-
-____$$+++_-
-___>>>___--
-___P_____--
-_____V___--
-_________--
---------$$$
