14 26
--------------------------
------------___________---
----------______P__|___---
----------_____________---
---------______________---
---____________________---
---__________>>>>>$$$$$$--
---____B___>>>>$$$$$$$$$--
---______>>>>>>$$$$$$$$$$$
---______>>>B>>>>>$$$$$$--
---____+++++++++++++++++--
---___+++M+++++++++++++---
---+++++++++++++++++++++--
--------------------------
