15 26
--------------------------
-________B_______---------
-_M__|__$$$______---------
-___+++++________---------
-___+++++___________------
-___P_____++++++++___-----
-_____V__>>+++++++++++++--
-_________>>$$$$$$$$$$$$--
-_________>>$$$$$$$$$$$$--
-_________>>$$$$$$$$$$$$--
-_________>>$$$$$$$$$$$$--
-_________>>$$$$$$$$$$$$--
-_________>>$$$$$$$$$$$$--
-_________>>$$$$$$$$$$$$--
---------$$$$$$$$$>>------
