14 26
--------------------------
-________B_______---------
-_M__|__$$$$_____---------
-___+++++________---------
-___+++++___________------
-___P_____++++++++___-----
-________>>+++++>>++++++--
-_________>>$$$$++$$$$$$--
-_______V_>>>+++++$$$$$$--
-_________>>+++$$$$$$$$$--
-_________>>$$$$$$$$$$$$--
-_________>>$$$$$$$$$$$$--
-_________>>$$$$$$$$$$$$--
---------$$$$$$$$$>>------
